5 10
|--------|
|.F.|..-.|
|..-|.@P.|
|.F....|.|
|--------|
